8 8 1
...@@@@.
......C@
@@......
...@@...
....@...
....@@.@
.@@@....
@K......